~~~~~~~~~~~~~~~~~~~~~~~~
~....====....=.=..=...=~
~.=.=.=====..=...=.=...~
~.=..=..=......==..=..=~
~..=.=..=====...=.=.===~
~..=.=.===.=...===.....~
~..=..=.....====....==.~
=..==...=.=..=.=......=~
~=.=.====.........=====~
~.......==.=.=..=.=.==.~
~.=..=...=.=.=...=====.~
~~~~~~~~~~~~~~~~~~~~~~~~