~~~~~~~~
~......~
~.=....~
~.=....~
~.====.~
~......~
~~~~~~~~