~~~~~~~~~~
~........~
~.======.~
~.======.~
~........~
~~~~~~~~~~