~~~~~~~~~
~....=..~
~.==.==.~
~.==.==.~
~.==.==.~
~.==.==.~
~.==.==.~
~.==.==.~
~.......~
~~~~~~~~~