~~~~~~~~~~~~~
~....=...=..~
~=======.===~
~..=...=.=..~
~..=....==..~
~..=..=..=..~
~~~~~~~~~~~~~
