~~~~~~~~~~~
~......=..~
~.==...==.~
~..=......~
~~~~~~~~~~~